##############
#............#
#............#
#...#....#...#
#............#
#...#..@.#...#
#............#
#...#....#...#
#............#
#............#
#...###......#
#...###......#
#............#
##############