##################################
#................................#
#................................#
#................................#
#................................#
#................................#
#...........############.........#
#...........#....................#
#...........#....................#
#...........#....................#
#...........#....................#
#...........#....................#
#................................#
#................................#
#................................#
#...........############.........#
#......................#.........#
#......................#.........#
#......................#.........#
#......................#.........#
#................................#
#................................#
#................................#
#................................#
#................................#
#................................#
#................................#
#............###########.........#
#............###########.........#
#............###########.........#
#................................#
#................................#
#................................#
##################################