################################################################################
#..............................................................................#
#..............................................................................#
#...####..####..####..####..####..####..####..####..####..####..####..#####....#
#..............................................................................#
#..............................................................................#
#..............................................................................#
#..............................................................................#
#..............................................................................#
#..............................................................................#
#...###...###...###...###...###...###...###...###...###...###...###...###......#
#...###...###...###...###...###...###...###...###...###...###...###...###......#
#..............................................................................#
#..............................................................................#
#..............................................................................#
#..............................................................................#
#..............................................................................#
#..............................................................................#
#..............................................................................#
#..............................................................................#
#............##########...................##......##.....##....................#
#............##########...................##......##.....##....................#
#............##########........................................................#
#............##########........................................................#
#..............................................................................#
#..............................................................................#
#..............................................................................#
#..............................................................................#
#..............................................................................#
#..............................................................................#
#..............................................................................#
#..............................................................................#
#..............................................................................#
#..............................................................................#
#..............................................................................#
#..............................................................................#
#..............................................................................#
#..............................................................................#
#..............................................................................#
#....................................#################.........................#
#....................................#################.........................#
#....................................#################.........................#
#....................................#################.........................#
#..............................................................................#
#..............................................................................#
#..............................................................................#
#..............................................................................#
#..............................................................................#
#........................................................####..................#
#........................................................####..................#
#........................................................####..................#
#........................................................####..................#
#...#....................................................####..................#
#...#....................................................####..................#
#...#.......##########################...................####..................#
#...#.......##########################...................####..................#
#...#.......##########################...................####..................#
#...#....................................................####..................#
#...#....................................................####..................#
#...#....................................................####..................#
#...#....................................................####..................#
#...#....................................................####..................#
#...#..........................................................................#
#...#..........................................................................#
#...#..........................................................................#
#...##########################################.................................#
#..............................................................................#
#..............................................................................#
#..............................................................................#
#..............................................................................#
#..............................................................................#
#..............................................................................#
#..............................................................................#
#..............................................................................#
#..............................................................................#
#..............................................................................#
#..............................................................................#
#..............................................................................#
#..............................................................................#
################################################################################